    #####
    #   #
    #   #
  ###   ###
  #       #
### # ### #     ######
#   # ### ######   ..#
#                  ..#
##### #### # ####  ..#
    #      ###  ######
    ########